{
  "lands": {
    "floors": [
      { "k": [0, 0, 0, 0, 0], "v": { "t": [0, 0] } },
      { "k": [1, 0, 0, 0, 0], "v": { "t": [1, 0] } },
      { "k": [2, 0, 0, 0, 0], "v": { "t": [2, 0] } },
      { "k": [3, 0, 0, 0, 0], "v": { "t": [0, 0] } },
      { "k": [4, 0, 0, 0, 0], "v": { "t": [1, 0] } },
      { "k": [5, 0, 0, 0, 0], "v": { "t": [2, 0] } },
      { "k": [6, 0, 0, 0, 0], "v": { "t": [3, 0] } },
      { "k": [7, 0, 0, 0, 0], "v": { "t": [4, 0] } },

      { "k": [0, 0, 0, 1, 0], "v": { "t": [0, 1] } },
      { "k": [1, 0, 0, 1, 0], "v": { "t": [1, 1] } },
      { "k": [2, 0, 0, 1, 0], "v": { "t": [2, 1] } },
      { "k": [3, 0, 0, 1, 0], "v": { "t": [3, 1] } },
      { "k": [4, 0, 0, 1, 0], "v": { "t": [4, 1] } },
      { "k": [5, 0, 0, 1, 0], "v": { "t": [0, 1] } },
      { "k": [6, 0, 0, 1, 0], "v": { "t": [1, 1] } },
      { "k": [7, 0, 0, 1, 0], "v": { "t": [2, 1] } },

      { "k": [0, 0, 0, 2, 0], "v": { "t": [0, 2] } },
      { "k": [1, 0, 0, 2, 0], "v": { "t": [1, 2] } },
      { "k": [2, 0, 0, 2, 0], "v": { "t": [2, 2] } },
      { "k": [3, 0, 0, 2, 0], "v": { "t": [3, 2] } },
      { "k": [4, 0, 0, 2, 0], "v": { "t": [4, 2] } },
      { "k": [5, 0, 0, 2, 0], "v": { "t": [0, 2] } },
      { "k": [6, 0, 0, 2, 0], "v": { "t": [1, 2] } },
      { "k": [7, 0, 0, 2, 0], "v": { "t": [2, 2] } },

      { "k": [0, 0, 0, 3, 0], "v": { "t": [0, 0] } },
      { "k": [1, 0, 0, 3, 0], "v": { "t": [1, 0] } },
      { "k": [2, 0, 0, 3, 0], "v": { "t": [0, 0] } },
      { "k": [3, 0, 0, 3, 0], "v": { "t": [1, 0] } },
      { "k": [4, 0, 0, 3, 0], "v": { "t": [0, 0] } },
      { "k": [5, 0, 0, 3, 0], "v": { "t": [1, 0] } },
      { "k": [6, 0, 0, 3, 0], "v": { "t": [0, 0] } },
      { "k": [7, 0, 0, 3, 0], "v": { "t": [1, 0] } },

      { "k": [0, 0, 0, 4, 0], "v": { "t": [0, 1] } },
      { "k": [1, 0, 0, 4, 0], "v": { "t": [1, 1] } },
      { "k": [2, 0, 0, 4, 0], "v": { "t": [2, 1] } },
      { "k": [3, 0, 0, 4, 0], "v": { "t": [3, 1] } },
      { "k": [4, 0, 0, 4, 0], "v": { "t": [4, 1] } },
      { "k": [5, 0, 0, 4, 0], "v": { "t": [0, 0] } },
      { "k": [6, 0, 0, 4, 0], "v": { "t": [1, 0] } },
      { "k": [7, 0, 0, 4, 0], "v": { "t": [2, 0] } },

      { "k": [0, 0, 0, 5, 0], "v": { "t": [3, 0] } },
      { "k": [1, 0, 0, 5, 0], "v": { "t": [4, 0] } },
      { "k": [2, 0, 0, 5, 0], "v": { "t": [0, 0] } },
      { "k": [3, 0, 0, 5, 0], "v": { "t": [1, 0] } },
      { "k": [4, 0, 0, 5, 0], "v": { "t": [2, 0] } },
      { "k": [5, 0, 0, 5, 0], "v": { "t": [3, 0] } },
      { "k": [6, 0, 0, 5, 0], "v": { "t": [4, 0] } },
      { "k": [7, 0, 0, 5, 0], "v": { "t": [0, 0] } },

      { "k": [0, 0, 0, 6, 0], "v": { "t": [0, 0] } },
      { "k": [1, 0, 0, 6, 0], "v": { "t": [0, 0] } },
      { "k": [2, 0, 0, 6, 0], "v": { "t": [0, 0] } },
      { "k": [3, 0, 0, 6, 0], "v": { "t": [0, 0] } },
      { "k": [4, 0, 0, 6, 0], "v": { "t": [0, 0] } },
      { "k": [5, 0, 0, 6, 0], "v": { "t": [0, 0] } },
      { "k": [6, 0, 0, 6, 0], "v": { "t": [0, 0] } },
      { "k": [7, 0, 0, 6, 0], "v": { "t": [0, 0] } },

      { "k": [0, 0, 0, 7, 0], "v": { "t": [0, 0] } },
      { "k": [1, 0, 0, 7, 0], "v": { "t": [0, 0] } },
      { "k": [2, 0, 0, 7, 0], "v": { "t": [0, 0] } },
      { "k": [3, 0, 0, 7, 0], "v": { "t": [0, 0] } },
      { "k": [4, 0, 0, 7, 0], "v": { "t": [0, 0] } },
      { "k": [5, 0, 0, 7, 0], "v": { "t": [0, 0] } },
      { "k": [6, 0, 0, 7, 0], "v": { "t": [0, 0] } },
      { "k": [7, 0, 0, 7, 0], "v": { "t": [0, 0] } },

      { "k": [0, 1, 0, 3, 0], "v": { "t": [3, 2] } },
      { "k": [1, 1, 0, 3, 0], "v": { "t": [4, 2] } },
      { "k": [2, 1, 0, 3, 0], "v": { "t": [3, 2] } }
    ]
  }
}
